Rk,Team,Seed,Date,PTS,,Opp,Opp Seed,Result,Round,Region,MP,FG,FGA,FG%,2P,2PA,2P%,3P,3PA,3P%,FT,FTA,FT%,PTS,FG,FGA,FG%,2P,2PA,2P%,3P,3PA,3P%,FT,FTA,FT%,PTS
1,Alabama,1,2023-03-16 NCAA,96,N,Texas A&M–Corpus Christi,16,W 96-75,Rnd of 64,South,200,33,70,.471,18,37,.486,15,33,.455,15,23,.652,96,26,75,.347,19,55,.345,7,20,.350,16,18,.889,75
2,Kansas,1,2023-03-16 NCAA,96,N,Howard,16,W 96-68,Rnd of 64,West,200,38,73,.521,29,51,.569,9,22,.409,11,13,.846,96,26,67,.388,16,35,.457,10,32,.313,6,10,.600,68
3,Connecticut,4,2023-03-17 NCAA,87,N,Iona,13,W 87-63,Rnd of 64,West,200,32,66,.485,21,41,.512,11,25,.440,12,14,.857,87,22,57,.386,15,41,.366,7,16,.438,12,16,.750,63
4,UCLA,2,2023-03-16 NCAA,86,N,UNC Asheville,15,W 86-53,Rnd of 64,West,200,34,63,.540,29,47,.617,5,16,.313,13,17,.765,86,19,51,.373,13,31,.419,6,20,.300,9,13,.692,53
5,Auburn,9,2023-03-16 NCAA,83,N,Iowa,8,W 83-75,Rnd of 64,Midwest,200,29,63,.460,21,41,.512,8,22,.364,17,22,.773,83,28,68,.412,21,41,.512,7,27,.259,12,17,.706,75
6,Gonzaga,3,2023-03-17 NCAA,82,N,Grand Canyon,14,W 82-70,Rnd of 64,West,200,30,56,.536,23,41,.561,7,15,.467,15,19,.789,82,28,65,.431,19,41,.463,9,24,.375,5,7,.714,70
7,Texas,2,2023-03-16 NCAA,81,N,Colgate,15,W 81-61,Rnd of 64,Midwest,200,31,58,.534,18,35,.514,13,23,.565,6,8,.750,81,25,58,.431,22,43,.512,3,15,.200,8,9,.889,61
8,Marquette,2,2023-03-17 NCAA,78,N,Vermont,15,W 78-61,Rnd of 64,East,200,29,56,.518,19,36,.528,10,20,.500,10,15,.667,78,23,53,.434,15,28,.536,8,25,.320,7,10,.700,61
9,Kansas State,3,2023-03-17 NCAA,77,N,Montana State,14,W 77-65,Rnd of 64,East,200,32,55,.582,28,40,.700,4,15,.267,9,12,.750,77,25,54,.463,19,33,.576,6,21,.286,9,17,.529,65
10,Penn State,10,2023-03-16 NCAA,76,N,Texas A&M,7,W 76-59,Rnd of 64,Midwest,200,27,56,.482,14,34,.412,13,22,.591,9,11,.818,76,20,59,.339,10,25,.400,10,34,.294,9,12,.750,59
11,Missouri,7,2023-03-16 NCAA,76,N,Utah State,10,W 76-65,Rnd of 64,South,200,27,53,.509,17,28,.607,10,25,.400,12,18,.667,76,28,59,.475,24,35,.686,4,24,.167,5,8,.625,65
12,Texas A&M–Corpus Christi,16,2023-03-16 NCAA,75,N,Alabama,1,L 75-96,Rnd of 64,South,200,26,75,.347,19,55,.345,7,20,.350,16,18,.889,75,33,70,.471,18,37,.486,15,33,.455,15,23,.652,96
13,Iowa,8,2023-03-16 NCAA,75,N,Auburn,9,L 75-83,Rnd of 64,Midwest,200,28,68,.412,21,41,.512,7,27,.259,12,17,.706,75,29,63,.460,21,41,.512,8,22,.364,17,22,.773,83
14,Northwestern,7,2023-03-16 NCAA,75,N,Boise State,10,W 75-67,Rnd of 64,West,200,26,53,.491,18,32,.563,8,21,.381,15,18,.833,75,26,65,.400,20,42,.476,6,23,.261,9,14,.643,67
15,Baylor,3,2023-03-17 NCAA,74,N,UC Santa Barbara,14,W 74-56,Rnd of 64,South,199,28,51,.549,20,29,.690,8,22,.364,10,16,.625,74,23,49,.469,19,33,.576,4,16,.250,6,9,.667,56
16,Duke,5,2023-03-16 NCAA,74,N,Oral Roberts,12,W 74-51,Rnd of 64,East,200,31,64,.484,25,48,.521,6,16,.375,6,9,.667,74,19,63,.302,11,31,.355,8,32,.250,5,8,.625,51
17,Arkansas,8,2023-03-16 NCAA,73,N,Illinois,9,W 73-63,Rnd of 64,West,200,24,63,.381,21,52,.404,3,11,.273,22,29,.759,73,20,52,.385,14,30,.467,6,22,.273,17,26,.654,63
18,Michigan State,7,2023-03-17 NCAA,72,N,Southern California,10,W 72-62,Rnd of 64,East,200,26,54,.481,21,40,.525,5,14,.357,15,25,.600,72,24,58,.414,17,38,.447,7,20,.350,7,8,.875,62
19,TCU,6,2023-03-17 NCAA,72,N,Arizona State,11,W 72-70,Rnd of 64,West,200,22,62,.355,14,39,.359,8,23,.348,20,27,.741,72,25,52,.481,17,35,.486,8,17,.471,12,18,.667,70
20,Creighton,6,2023-03-17 NCAA,72,N,NC State,11,W 72-63,Rnd of 64,South,200,26,56,.464,23,36,.639,3,20,.150,17,19,.895,72,24,64,.375,21,50,.420,3,14,.214,12,15,.800,63
21,Xavier,3,2023-03-17 NCAA,72,N,Kennesaw State,14,W 72-67,Rnd of 64,Midwest,200,24,52,.462,22,40,.550,2,12,.167,22,30,.733,72,27,64,.422,22,45,.489,5,19,.263,8,13,.615,67
22,Indiana,4,2023-03-17 NCAA,71,N,Kent State,13,W 71-60,Rnd of 64,Midwest,200,29,62,.468,24,48,.500,5,14,.357,8,11,.727,71,22,69,.319,15,48,.313,7,21,.333,9,12,.750,60
23,Grand Canyon,14,2023-03-17 NCAA,70,N,Gonzaga,3,L 70-82,Rnd of 64,West,200,28,65,.431,19,41,.463,9,24,.375,5,7,.714,70,30,56,.536,23,41,.561,7,15,.467,15,19,.789,82
24,Arizona State,11,2023-03-17 NCAA,70,N,TCU,6,L 70-72,Rnd of 64,West,200,25,52,.481,17,35,.486,8,17,.471,12,18,.667,70,22,62,.355,14,39,.359,8,23,.348,20,27,.741,72
25,Howard,16,2023-03-16 NCAA,68,N,Kansas,1,L 68-96,Rnd of 64,West,200,26,67,.388,16,35,.457,10,32,.313,6,10,.600,68,38,73,.521,29,51,.569,9,22,.409,11,13,.846,96
26,Furman,13,2023-03-16 NCAA,68,N,Virginia,4,W 68-67,Rnd of 64,South,200,22,56,.393,12,28,.429,10,28,.357,14,19,.737,68,24,54,.444,22,42,.524,2,12,.167,17,22,.773,67
27,Kennesaw State,14,2023-03-17 NCAA,67,N,Xavier,3,L 67-72,Rnd of 64,Midwest,200,27,64,.422,22,45,.489,5,19,.263,8,13,.615,67,24,52,.462,22,40,.550,2,12,.167,22,30,.733,72
28,Maryland,8,2023-03-16 NCAA,67,N,West Virginia,9,W 67-65,Rnd of 64,South,200,23,45,.511,17,27,.630,6,18,.333,15,22,.682,67,22,56,.393,14,37,.378,8,19,.421,13,16,.813,65
29,Virginia,4,2023-03-16 NCAA,67,N,Furman,13,L 67-68,Rnd of 64,South,200,24,54,.444,22,42,.524,2,12,.167,17,22,.773,67,22,56,.393,12,28,.429,10,28,.357,14,19,.737,68
30,Boise State,10,2023-03-16 NCAA,67,N,Northwestern,7,L 67-75,Rnd of 64,West,200,26,65,.400,20,42,.476,6,23,.261,9,14,.643,67,26,53,.491,18,32,.563,8,21,.381,15,18,.833,75
31,Florida Atlantic,9,2023-03-17 NCAA,66,N,Memphis,8,W 66-65,Rnd of 64,East,200,25,65,.385,17,37,.459,8,28,.286,8,11,.727,66,25,58,.431,19,36,.528,6,22,.273,9,12,.750,65
32,Montana State,14,2023-03-17 NCAA,65,N,Kansas State,3,L 65-77,Rnd of 64,East,200,25,54,.463,19,33,.576,6,21,.286,9,17,.529,65,32,55,.582,28,40,.700,4,15,.267,9,12,.750,77
33,Memphis,8,2023-03-17 NCAA,65,N,Florida Atlantic,9,L 65-66,Rnd of 64,East,200,25,58,.431,19,36,.528,6,22,.273,9,12,.750,65,25,65,.385,17,37,.459,8,28,.286,8,11,.727,66
34,West Virginia,9,2023-03-16 NCAA,65,N,Maryland,8,L 65-67,Rnd of 64,South,200,22,56,.393,14,37,.378,8,19,.421,13,16,.813,65,23,45,.511,17,27,.630,6,18,.333,15,22,.682,67
35,Utah State,10,2023-03-16 NCAA,65,N,Missouri,7,L 65-76,Rnd of 64,South,200,28,59,.475,24,35,.686,4,24,.167,5,8,.625,65,27,53,.509,17,28,.607,10,25,.400,12,18,.667,76
36,FDU,16,2023-03-17 NCAA,63,N,Purdue,1,W 63-58,Rnd of 64,East,200,24,62,.387,17,39,.436,7,23,.304,8,10,.800,63,19,53,.358,14,27,.519,5,26,.192,15,19,.789,58
37,St. Mary's (CA),5,2023-03-17 NCAA,63,N,VCU,12,W 63-51,Rnd of 64,West,200,20,49,.408,17,32,.531,3,17,.176,20,27,.741,63,18,49,.367,13,35,.371,5,14,.357,10,16,.625,51
38,Iona,13,2023-03-17 NCAA,63,N,Connecticut,4,L 63-87,Rnd of 64,West,200,22,57,.386,15,41,.366,7,16,.438,12,16,.750,63,32,66,.485,21,41,.512,11,25,.440,12,14,.857,87
39,Miami (FL),5,2023-03-17 NCAA,63,N,Drake,12,W 63-56,Rnd of 64,Midwest,200,17,56,.304,11,38,.289,6,18,.333,23,29,.793,63,22,55,.400,15,31,.484,7,24,.292,5,8,.625,56
40,NC State,11,2023-03-17 NCAA,63,N,Creighton,6,L 63-72,Rnd of 64,South,200,24,64,.375,21,50,.420,3,14,.214,12,15,.800,63,26,56,.464,23,36,.639,3,20,.150,17,19,.895,72
41,Houston,1,2023-03-16 NCAA,63,N,Northern Kentucky,16,W 63-52,Rnd of 64,Midwest,200,25,51,.490,21,35,.600,4,16,.250,9,10,.900,63,19,69,.275,14,36,.389,5,33,.152,9,10,.900,52
42,San Diego State,5,2023-03-16 NCAA,63,N,College of Charleston,12,W 63-57,Rnd of 64,South,200,24,56,.429,20,40,.500,4,16,.250,11,18,.611,63,18,56,.321,13,32,.406,5,24,.208,16,19,.842,57
43,Illinois,9,2023-03-16 NCAA,63,N,Arkansas,8,L 63-73,Rnd of 64,West,200,20,52,.385,14,30,.467,6,22,.273,17,26,.654,63,24,63,.381,21,52,.404,3,11,.273,22,29,.759,73
44,Southern California,10,2023-03-17 NCAA,62,N,Michigan State,7,L 62-72,Rnd of 64,East,200,24,58,.414,17,38,.447,7,20,.350,7,8,.875,62,26,54,.481,21,40,.525,5,14,.357,15,25,.600,72
45,Vermont,15,2023-03-17 NCAA,61,N,Marquette,2,L 61-78,Rnd of 64,East,200,23,53,.434,15,28,.536,8,25,.320,7,10,.700,61,29,56,.518,19,36,.528,10,20,.500,10,15,.667,78
46,Kentucky,6,2023-03-17 NCAA,61,N,Providence,11,W 61-53,Rnd of 64,East,200,23,63,.365,18,47,.383,5,16,.313,10,13,.769,61,21,58,.362,16,34,.471,5,24,.208,6,11,.545,53
47,Colgate,15,2023-03-16 NCAA,61,N,Texas,2,L 61-81,Rnd of 64,Midwest,200,25,58,.431,22,43,.512,3,15,.200,8,9,.889,61,31,58,.534,18,35,.514,13,23,.565,6,8,.750,81
48,Kent State,13,2023-03-17 NCAA,60,N,Indiana,4,L 60-71,Rnd of 64,Midwest,200,22,69,.319,15,48,.313,7,21,.333,9,12,.750,60,29,62,.468,24,48,.500,5,14,.357,8,11,.727,71
49,Pittsburgh,11,2023-03-17 NCAA,59,N,Iowa State,6,W 59-41,Rnd of 64,Midwest,200,14,41,.341,8,22,.364,6,19,.316,25,29,.862,59,14,60,.233,12,39,.308,2,21,.095,11,19,.579,41
50,Texas A&M,7,2023-03-16 NCAA,59,N,Penn State,10,L 59-76,Rnd of 64,Midwest,200,20,59,.339,10,25,.400,10,34,.294,9,12,.750,59,27,56,.482,14,34,.412,13,22,.591,9,11,.818,76
51,Princeton,15,2023-03-16 NCAA,59,N,Arizona,2,W 59-55,Rnd of 64,South,200,26,64,.406,22,39,.564,4,25,.160,3,5,.600,59,24,57,.421,21,41,.512,3,16,.188,4,7,.571,55
52,Purdue,1,2023-03-17 NCAA,58,N,FDU,16,L 58-63,Rnd of 64,East,200,19,53,.358,14,27,.519,5,26,.192,15,19,.789,58,24,62,.387,17,39,.436,7,23,.304,8,10,.800,63
53,Tennessee,4,2023-03-16 NCAA,58,N,Louisiana,13,W 58-55,Rnd of 64,East,200,21,46,.457,17,30,.567,4,16,.250,12,21,.571,58,22,55,.400,16,37,.432,6,18,.333,5,9,.556,55
54,College of Charleston,12,2023-03-16 NCAA,57,N,San Diego State,5,L 57-63,Rnd of 64,South,200,18,56,.321,13,32,.406,5,24,.208,16,19,.842,57,24,56,.429,20,40,.500,4,16,.250,11,18,.611,63
55,UC Santa Barbara,14,2023-03-17 NCAA,56,N,Baylor,3,L 56-74,Rnd of 64,South,200,23,49,.469,19,33,.576,4,16,.250,6,9,.667,56,28,51,.549,20,29,.690,8,22,.364,10,16,.625,74
56,Drake,12,2023-03-17 NCAA,56,N,Miami (FL),5,L 56-63,Rnd of 64,Midwest,200,22,55,.400,15,31,.484,7,24,.292,5,8,.625,56,17,56,.304,11,38,.289,6,18,.333,23,29,.793,63
57,Arizona,2,2023-03-16 NCAA,55,N,Princeton,15,L 55-59,Rnd of 64,South,200,24,57,.421,21,41,.512,3,16,.188,4,7,.571,55,26,64,.406,22,39,.564,4,25,.160,3,5,.600,59
58,Louisiana,13,2023-03-16 NCAA,55,N,Tennessee,4,L 55-58,Rnd of 64,East,200,22,55,.400,16,37,.432,6,18,.333,5,9,.556,55,21,46,.457,17,30,.567,4,16,.250,12,21,.571,58
59,Providence,11,2023-03-17 NCAA,53,N,Kentucky,6,L 53-61,Rnd of 64,East,200,21,58,.362,16,34,.471,5,24,.208,6,11,.545,53,23,63,.365,18,47,.383,5,16,.313,10,13,.769,61
60,UNC Asheville,15,2023-03-16 NCAA,53,N,UCLA,2,L 53-86,Rnd of 64,West,200,19,51,.373,13,31,.419,6,20,.300,9,13,.692,53,34,63,.540,29,47,.617,5,16,.313,13,17,.765,86
61,Northern Kentucky,16,2023-03-16 NCAA,52,N,Houston,1,L 52-63,Rnd of 64,Midwest,200,19,69,.275,14,36,.389,5,33,.152,9,10,.900,52,25,51,.490,21,35,.600,4,16,.250,9,10,.900,63
62,VCU,12,2023-03-17 NCAA,51,N,St. Mary's (CA),5,L 51-63,Rnd of 64,West,200,18,49,.367,13,35,.371,5,14,.357,10,16,.625,51,20,49,.408,17,32,.531,3,17,.176,20,27,.741,63
63,Oral Roberts,12,2023-03-16 NCAA,51,N,Duke,5,L 51-74,Rnd of 64,East,200,19,63,.302,11,31,.355,8,32,.250,5,8,.625,51,31,64,.484,25,48,.521,6,16,.375,6,9,.667,74
64,Iowa State,6,2023-03-17 NCAA,41,N,Pittsburgh,11,L 41-59,Rnd of 64,Midwest,200,14,60,.233,12,39,.308,2,21,.095,11,19,.579,41,14,41,.341,8,22,.364,6,19,.316,25,29,.862,59